"aa" = (/turf/open/floor/plating/ground/mars/random/tile,/area/bigredv2/caves)
"ab" = (/turf/closed/mineral,/area/bigredv2/caves)
"ac" = (/turf/open/space/basic,/area/space)
"ao" = (/obj/structure/mars_misc/x48/coil,/turf/open/floor/plating/ground/mars/random/tile,/area/bigredv2/outside)
"aL" = (/obj/structure/mars_misc/tank,/obj/machinery/atmospherics/pipe/simple/general,/turf/open/floor/plating/ground/mars/random/tile,/area/bigredv2/outside)
"bd" = (/obj/machinery/atmospherics/pipe/simple/green{dir = 10},/turf/open/floor/plating/ground/mars/random/tile,/area/bigredv2/outside)
"bP" = (/obj/machinery/atmospherics/pipe/simple/green,/turf/open/floor/martiantile,/area/bigredv2/outside)
"cd" = (/obj/structure/mars_misc/x48/electrolyzer/alt/left,/obj/machinery/atmospherics/pipe/simple/general{dir = 8},/turf/open/floor/plating/ground/mars/random/tile,/area/bigredv2/outside)
"dm" = (/turf/closed/mineral,/area/bigredv2/outside)
"dn" = (/obj/machinery/atmospherics/pipe/simple/green{dir = 4},/turf/open/floor/martiantile,/area/bigredv2/outside)
"eh" = (/obj/structure/mars_misc/x48/grid,/obj/machinery/atmospherics/pipe/simple/green{dir = 9},/turf/open/floor/martiantile,/area/bigredv2/outside)
"ej" = (/obj/machinery/atmospherics/pipe/simple/green,/turf/open/floor/plating/ground/mars/random/tile,/area/bigredv2/outside)
"eJ" = (/obj/machinery/atmospherics/pipe/simple/green{dir = 4},/turf/open/floor/plating/warning{dir = 4},/area/bigredv2/outside)
"gE" = (/obj/machinery/atmospherics/pipe/simple/cyan{dir = 10},/turf/open/floor/plating/ground/mars/random/tile,/area/bigredv2/outside)
"gI" = (/obj/effect/decal/mars_rocks/crater,/turf/open/floor/plating/ground/mars/random/tile,/area/bigredv2/outside)
"hK" = (/obj/structure/mars_misc/tank,/turf/open/floor/plating/ground/mars/random/tile,/area/bigredv2/outside)
"hN" = (/obj/structure/mars_misc/x48/ipc,/turf/open/floor/plating/warning,/area/bigredv2/outside)
"iL" = (/obj/machinery/atmospherics/pipe/simple/green{dir = 4},/obj/structure/sign/electricshock,/turf/open/floor/plating/warning{dir = 6},/area/bigredv2/outside)
"jC" = (/obj/structure/mars_misc/x48/heater/left,/obj/machinery/atmospherics/pipe/simple/green{dir = 10},/turf/open/floor/plating/ground/mars/random/tile,/area/bigredv2/outside)
"ki" = (/obj/machinery/atmospherics/pipe/simple/green{dir = 1},/turf/open/floor/martiantile,/area/bigredv2/outside)
"kH" = (/obj/effect/decal/mars_rocks/crater/large,/turf/open/floor/plating/ground/mars/random/tile,/area/bigredv2/outside)
"lA" = (/obj/structure/mars_misc/x48/grid,/obj/machinery/atmospherics/pipe/manifold4w/green,/turf/open/floor/martiantile,/area/bigredv2/outside)
"lN" = (/obj/structure/mars_misc/tank/oxy,/obj/machinery/atmospherics/pipe/manifold/cyan,/turf/open/floor/plating/ground/mars/random/tile,/area/bigredv2/outside)
"lV" = (/obj/effect/landmark/start/job/natsf_soldier,/turf/open/floor/plating/ground/mars/random/tile,/area/bigredv2/outside)
"ms" = (/obj/structure/mars_misc/x64/turbine/right,/turf/open/floor/plating/ground/mars/random/tile,/area/bigredv2/outside)
"mz" = (/obj/machinery/atmospherics/pipe/simple/cyan{dir = 9},/turf/open/floor/plating/ground/mars/random/tile,/area/bigredv2/outside)
"mJ" = (/obj/structure/mars_misc/x48/electrolyzer/right,/obj/machinery/atmospherics/pipe/manifold,/turf/open/floor/plating/ground/mars/random/tile,/area/bigredv2/outside)
"mM" = (/obj/machinery/atmospherics/pipe/simple/green{dir = 5},/turf/open/floor/plating/ground/mars/random/tile,/area/bigredv2/outside)
"mR" = (/obj/effect/decal/mars_rocks/rock,/turf/closed/mineral,/area/bigredv2/outside)
"mW" = (/obj/structure/mars_misc/x48/electrolyzer/alt/right,/obj/machinery/atmospherics/pipe/simple/general{dir = 9},/turf/open/floor/plating/ground/mars/random/tile,/area/bigredv2/outside)
"oh" = (/obj/machinery/atmospherics/pipe/simple/cyan,/turf/open/floor/plating/ground/mars/random/tile,/area/bigredv2/outside)
"pk" = (/obj/machinery/atmospherics/pipe/simple/orange{dir = 4},/turf/open/floor/plating/ground/mars/random/tile,/area/bigredv2/outside)
"pv" = (/obj/structure/mars_misc/tank/hydrogen,/obj/machinery/atmospherics/pipe/simple/cyan{dir = 8},/turf/open/floor/plating/ground/mars/random/tile,/area/bigredv2/outside)
"pX" = (/turf/open/floor/plating/warning{dir = 8},/area/bigredv2/outside)
"qX" = (/obj/machinery/atmospherics/pipe/manifold/cyan{dir = 1},/turf/open/floor/plating/ground/mars/random/tile,/area/bigredv2/outside)
"sv" = (/turf/open/floor/plating/warning{dir = 5},/area/bigredv2/outside)
"tk" = (/obj/structure/mars_misc/x48/grid,/obj/machinery/atmospherics/pipe/simple/green{dir = 10},/turf/open/floor/martiantile,/area/bigredv2/outside)
"uI" = (/obj/machinery/atmospherics/pipe/simple/green{dir = 4},/turf/open/floor/plating/ground/mars/random/tile,/area/bigredv2/outside)
"vr" = (/obj/structure/mars_misc/x48/electrolyzer/left,/obj/machinery/atmospherics/pipe/simple/green{dir = 6},/turf/open/floor/plating/ground/mars/random/tile,/area/bigredv2/outside)
"vy" = (/obj/machinery/atmospherics/pipe/simple/cyan{dir = 8},/turf/open/floor/martiantile,/area/bigredv2/outside)
"vF" = (/turf/open/chasm,/area/bigredv2/outside)
"wX" = (/obj/machinery/atmospherics/pipe/simple/cyan,/turf/open/floor/plating/warning{dir = 1},/area/bigredv2/outside)
"xh" = (/obj/structure/mars_misc/x48/heater/left,/turf/open/floor/plating/ground/mars/random/tile,/area/bigredv2/outside)
"xP" = (/obj/machinery/atmospherics/pipe/simple/orange{dir = 8},/turf/open/floor/plating/ground/mars/random/tile,/area/bigredv2/outside)
"yt" = (/obj/structure/mars_misc/x48/coil/start,/turf/open/floor/plating/ground/mars/random/tile,/area/bigredv2/outside)
"yz" = (/turf/open/floor/plating/catwalk,/area/bigredv2/outside)
"yN" = (/obj/structure/mars_misc/tank/hydrogen,/obj/machinery/atmospherics/pipe/manifold{dir = 1},/turf/open/floor/plating/ground/mars/random/tile,/area/bigredv2/outside)
"zi" = (/obj/machinery/atmospherics/pipe/manifold/cyan,/turf/open/floor/plating/ground/mars/random/tile,/area/bigredv2/outside)
"AI" = (/obj/structure/mars_misc/x48/coil/end,/turf/open/floor/plating/ground/mars/random/tile,/area/bigredv2/outside)
"Bg" = (/obj/structure/sign/electricshock,/turf/open/floor/plating/warning{dir = 10},/area/bigredv2/outside)
"Cb" = (/obj/structure/mars_misc/tank,/obj/machinery/atmospherics/pipe/simple/general{dir = 6},/turf/open/floor/plating/ground/mars/random/tile,/area/bigredv2/outside)
"Cm" = (/obj/structure/mars_misc/tank/oxy,/turf/open/floor/martiantile,/area/bigredv2/outside)
"Di" = (/obj/structure/mars_misc/x64/sign/left,/turf/open/floor/plating/ground/mars/random/tile,/area/bigredv2/outside)
"Ea" = (/obj/effect/landmark/start/job/ussr_soldier,/turf/open/floor/plating/ground/mars/random/tile,/area/bigredv2/outside)
"EA" = (/obj/machinery/atmospherics/pipe/simple/general,/turf/open/floor/plating/ground/mars/random/tile,/area/bigredv2/outside)
"ER" = (/obj/machinery/atmospherics/pipe/manifold/green{dir = 8},/turf/open/floor/martiantile,/area/bigredv2/outside)
"Fw" = (/obj/structure/mars_misc/x48/grid,/obj/machinery/atmospherics/pipe/simple/green{dir = 6},/turf/open/floor/martiantile,/area/bigredv2/outside)
"Gg" = (/obj/effect/decal/mars_rocks/rock,/turf/open/floor/plating/ground/mars/random/tile,/area/bigredv2/outside)
"HG" = (/obj/machinery/atmospherics/pipe/simple/cyan{dir = 8},/turf/open/floor/plating/ground/mars/random/tile,/area/bigredv2/outside)
"HO" = (/obj/machinery/atmospherics/pipe/simple/green{dir = 4},/turf/open/floor/plating/warning,/area/bigredv2/outside)
"IA" = (/obj/effect/decal/mars_rocks/boulder,/turf/open/floor/plating/ground/mars/random/tile,/area/bigredv2/outside)
"NU" = (/obj/machinery/atmospherics/pipe/manifold/green,/turf/open/floor/plating/ground/mars/random/tile,/area/bigredv2/outside)
"NV" = (/obj/structure/mars_misc/tank/oxy,/turf/open/floor/plating/ground/mars/random/tile,/area/bigredv2/outside)
"Ov" = (/turf/open/floor/martiantile,/area/bigredv2/outside)
"OK" = (/obj/machinery/atmospherics/pipe/simple/green{dir = 5},/turf/open/floor/plating/warning,/area/bigredv2/outside)
"ON" = (/obj/machinery/atmospherics/pipe/simple/cyan{dir = 5},/turf/open/floor/martiantile,/area/bigredv2/outside)
"Pd" = (/turf/open/floor/plating/warning{dir = 10},/area/bigredv2/outside)
"PK" = (/obj/effect/decal/mars_rocks/rock,/obj/effect/decal/mars_rocks/boulder,/turf/open/floor/plating/ground/mars/random/tile,/area/bigredv2/outside)
"PL" = (/turf/open/floor/plating/ground/mars/random/tile,/area/bigredv2/outside)
"PZ" = (/obj/effect/decal/mars_rocks/crater/medium,/turf/open/floor/plating/ground/mars/random/tile,/area/bigredv2/outside)
"QI" = (/obj/structure/sign/electricshock,/turf/open/floor/plating/warning{dir = 5},/area/bigredv2/outside)
"Re" = (/obj/machinery/atmospherics/pipe/simple/green{dir = 9},/turf/open/floor/plating/ground/mars/random/tile,/area/bigredv2/outside)
"Rp" = (/obj/structure/mars_misc/x64/mech,/turf/open/floor/plating/catwalk,/area/bigredv2/outside)
"Sv" = (/turf/open/floor/plating/warning{dir = 9},/area/bigredv2/outside)
"SC" = (/obj/structure/mars_misc/x64/sign/right,/turf/open/floor/plating/ground/mars/random/tile,/area/bigredv2/outside)
"Tm" = (/turf/open/floor/plating/warning{dir = 6},/area/bigredv2/outside)
"TV" = (/obj/structure/mars_misc/x48/grid,/obj/machinery/atmospherics/pipe/simple/green{dir = 5},/turf/open/floor/martiantile,/area/bigredv2/outside)
"Uj" = (/obj/structure/mars_misc/x48/ipc,/turf/open/floor/martiantile,/area/bigredv2/outside)
"UU" = (/obj/structure/mars_misc/x64/turbine/left,/turf/open/floor/plating/ground/mars/random/tile,/area/bigredv2/outside)
"VZ" = (/obj/machinery/atmospherics/pipe/simple/cyan{dir = 8},/turf/open/floor/plating/warning{dir = 4},/area/bigredv2/outside)
"Wh" = (/obj/structure/mars_misc/x64/reactor_casing,/turf/open/floor/plating/ground/mars/random/tile,/area/bigredv2/outside)
"Wr" = (/obj/structure/sign/electricshock,/turf/open/floor/plating/warning{dir = 9},/area/bigredv2/outside)
"WC" = (/obj/machinery/atmospherics/pipe/simple/green,/turf/open/floor/plating/warning{dir = 1},/area/bigredv2/outside)
"WH" = (/turf/open/floor/plating/warning{dir = 4},/area/bigredv2/outside)
"XD" = (/turf/open/floor/plating/warning{dir = 1},/area/bigredv2/outside)
"XF" = (/obj/structure/mars_misc/x48/heater/right,/turf/open/floor/plating/ground/mars/random/tile,/area/bigredv2/outside)
"XW" = (/turf/open/floor/plating/warning,/area/bigredv2/outside)
"YP" = (/obj/machinery/atmospherics/pipe/manifold/cyan,/obj/machinery/atmospherics/pipe/manifold/cyan,/turf/open/floor/plating/ground/mars/random/tile,/area/bigredv2/outside)

(1,1,1) = {"
dmdmdmdmdmdmdmdmdmdmdmdmdmdmdmdmdmdmdmdmdmdmdmdmdmdmdmdmdmdmdmdmdmdmdmdmdmdmdmdmdmdmdmdmdmdmdmdmdmdmdmdmdmdmdmdmdmdmdmdmdmdmdmdmdmdmdmdmdmdmdmdmdmdmdmdmdmdmdmdmdmdmdmdmdmdmdmdmdmdmdmdmdmdmdmdmdmdmdmdmdmdmdmdmdmdmdmdmdmdmdmdmdmdmdmdmdmdmdmdmdmdmdmdmdmdmdmdm
dmdmdmdmdmdmdmdmdmdmdmdmdmdmdmdmdmdmdmdmdmdmdmdmdmdmdmdmdmdmdmdmdmdmdmdmdmdmdmdmdmdmdmdmdmdmdmPLPLPLgIPLPLPLPLPLPLPLPLPLPLPLPLvFPLPLPLPLgIPLPLPLPLPLPLPLPLPLdmdmdmdmdmdmdmdmdmdmdmdmdmdmdmdmdmdmdmdmdmdmdmdmdmdmdmdmdmdmdmdmdmdmdmdmdmdmdmdmdmdmdmdmdmdmdmdmdmdm
dmdmdmdmdmdmdmdmdmdmdmdmdmdmdmdmdmdmdmdmdmdmdmdmdmdmdmdmdmdmdmdmdmdmdmdmdmdmdmdmdmdmdmdmdmdmPLPLPLPLPLPLPLPLPLPLPLPLPLPLPLPLPLPLPLPLPLPLPLPLPLPLPLPLGgPLPLPLPLPLPLPLdmPLdmPLdmdmdmdmdmdmdmdmdmdmdmdmdmdmdmdmdmdmdmdmdmdmdmdmdmdmdmdmdmdmdmdmdmdmdmdmdmdmdmdmdmdm
dmdmdmdmdmdmdmdmdmdmdmdmdmdmdmdmdmdmdmdmdmdmdmdmdmdmdmdmdmdmdmdmdmdmdmdmdmdmdmdmdmdmdmdmPLPLGgPLPLPLPLPLPLPLPLPLPLPLPLPLPLPLPLPLPLPLPLPLPLPLPLPLPLPLPLPLPLPLPLPLPLPLPLPLPLPLPLdmPLdmdmdmdmdmdmdmdmdmdmdmdmdmdmdmdmdmdmdmdmdmdmdmdmdmdmdmdmdmdmdmdmdmdmdmdmdmdmdm
dmdmdmdmdmdmdmdmdmdmdmdmdmdmdmdmdmdmdmdmdmdmdmdmdmdmdmdmdmdmdmdmdmdmdmdmdmdmdmdmdmPLPLPLPLPLPLPLPLPLPLPLPLPLPLPLPLPLPLPLPLPLPLPLPLPLPLPLPLPLPLPLPLPLPLPLPLPLPLPLPLPLPLPLPLPLPLPLPLPLdmdmdmdmdmdmdmdmdmdmdmdmdmdmdmdmdmdmdmdmdmdmdmdmdmdmdmdmdmdmdmdmdmdmdmdmdmdm
dmdmdmdmdmdmdmdmdmdmdmdmdmdmdmdmdmdmdmdmdmdmdmdmdmdmdmdmdmdmdmdmdmdmdmdmdmvFPLPLPLPLPLPLPLPLPLPLPLPLPLPLPLPLPLPLPLPLPLPLPLPLPLPLPLPLPLPLPLPLPLPLPLPLPLPLPLPLPLPLPLPLPLPLPLPLPLPLPLPLPLPLdmdmdmdmdmdmdmdmdmdmdmdmdmdmdmdmdmdmdmdmdmdmdmdmdmdmdmdmdmdmdmdmdmdmdmdm
dmdmdmdmdmdmdmdmdmdmdmdmdmdmdmdmdmdmdmdmdmdmdmdmdmdmdmdmdmdmdmdmdmdmdmdmPLPLPLPLPLPLPLPLPLPLPLPLGgPLPLvFPLPLPLPLPLPLPLgIPLPLPLPLPLPLPLPLPLPLGgPLPLPLPLgIPLPLPLPLPLPZPLPLPLPLPLPLPLPLPLPLPLPLdmdmdmdmdmdmdmdmdmdmdmdmdmdmdmdmdmdmdmdmdmdmdmdmdmdmdmdmdmdmdmdmdmdm
dmdmdmdmdmdmdmdmdmdmdmdmdmdmdmdmdmdmdmdmdmdmdmdmdmdmdmdmdmdmdmdmdmdmdmdmPLPLPLCmOvCmOvCmOvhKytaoAIPLPLPLPLPLPLPLIAPLPLPLPLPLPLPLPLPLPLPLPLPLPLPLPLPLPLPLPLPLPLPLPLPLPLPLPLPLPLPLPLPLPLPLPLdmdmdmdmdmdmdmdmdmdmdmdmdmdmdmdmdmdmdmdmdmdmdmdmdmdmdmdmdmdmdmdmdmdmdm
dmdmdmdmdmdmdmdmdmdmdmdmdmdmdmdmdmdmdmdmdmdmdmdmdmdmdmdmdmdmdmdmdmdmdmdmPLPLPLOvOvOvOvOvOvPLPLPLPLPLPLPLPLPLPLPLPLPLPLPLPLPLPLPLPLPLPLPLPLPLPLPLPLPLPLPLPLPLPLPLPLPLPLPLPLPLPLPLPLPLPLPLPLdmdmdmdmdmdmdmdmdmdmdmdmdmdmdmdmdmdmdmdmdmdmdmdmdmdmdmdmdmdmdmdmdmdmdm
dmdmdmdmdmdmdmdmdmdmdmdmdmdmdmdmdmdmdmdmdmdmdmdmdmdmdmdmdmdmdmdmdmdmdmdmPLPLPLOvOvOvOvOvOvxhXFPLPLPLPLPLPLPLPLPLPLPLPLPLPLPLPLPLPLPLPLPLPLPLPLPLPLPLPLPLPLPLPLPLPLPLPLPLPLPLvFPLPLPLPLPLPLdmdmdmdmdmdmdmdmdmdmdmdmdmdmdmdmdmdmdmdmdmdmdmdmdmdmdmdmdmdmdmdmdmdmdm
dmdmdmdmdmdmdmdmdmdmdmdmdmdmdmdmdmdmdmdmdmdmdmdmdmdmdmdmdmdmdmdmdmdmdmdmPLPLPLOvOvOvOvOvOvPLPLPLPLPLPLPLGgPLPLPLPLPLPLPLPLPLPLPLPLPLPLPLPLgIPLPLPLPLPLPLPLPLPLPLPLPLPLPLPLPLPLPLPLPLPLPLPLPLdmdmdmdmdmdmdmdmdmdmdmdmdmdmdmdmdmdmdmdmdmdmdmdmdmdmdmdmdmdmdmdmdmdm
dmdmdmdmdmdmdmdmdmdmdmdmdmdmdmdmdmdmdmdmdmdmdmaaaaaaaaaaaaaaaaaaaaaaPLPLPLPLPLOvOvOvOvOvOvPLPLPLPLPLPLPLPLPLPLPLPLPLPLPLPLPLPZPLPLPLPLPLPLPLPLPLPLPLPLPLPLPLPLGgPLPLPLPLPLPLPLPLPLPLPLPLPLdmdmdmdmdmdmdmdmdmdmdmdmdmdmdmdmdmdmdmdmdmdmdmdmdmdmdmdmdmdmdmdmdmdmdm
dmdmdmdmdmdmdmdmdmdmdmdmdmdmdmdmdmdmdmdmaadmaaaaaadmdmdmdmdmdmaaaadmPLPLPLPLPLOvOvOvOvOvOvPLPLPLPLPLPLGgPLPLPLPLPLPLIAPLPLPLPLPLPLPLPLPLPLPLPLPLPLGgPLPLPLPLPLPLPLPLPLPLPLPLPLPLPLPLPLPLPLPLdmdmaaaadmdmdmdmdmdmdmdmdmdmdmdmdmdmdmdmdmdmdmdmdmdmdmdmdmdmdmdmdmdm
dmdmdmdmdmdmdmdmdmdmdmdmdmdmdmdmdmdmdmdmaaaaaaaadmdmdmdmdmdmdmdmdmdmPLGgPLPLPLPLPLPLPLPLPLPLPLPLPLPLPLPLPLPLPLPLPLPLPLPLPLPLPLPLPLPLPLPLPLPLPLPLPLPLPLPLPLPLPLPLPLPLPLPLPLPLPLPLPLPLPLPLPLPLdmaaaaaaaadmdmdmdmdmdmdmdmdmdmdmdmdmdmdmdmdmdmdmdmdmdmdmdmdmdmdmdmdm
dmdmdmdmdmdmdmdmdmdmdmdmdmdmdmdmdmdmaaaaaadmdmdmdmdmdmdmdmdmdmdmdmdmdmPLPLPLPLPLPLPLPLPLPLPLPLPLPLPLPLPLPLPLGgPLPLPLPLPLPLPLPLPLPLPLPLPLPLPLPLPLPLPLPLPLPLPLPLPLPLGgPLPLPLPLPLPLPLPLPLPLPLPLPLaadmdmaaaaaadmdmdmdmdmdmdmdmdmdmdmdmdmdmdmdmdmdmdmdmdmdmdmdmdmdmdm
dmdmdmdmdmdmdmdmdmdmdmdmdmdmdmdmdmdmaaaaaadmdmdmdmdmdmdmdmdmdmdmdmdmdmPLPLPLPLPLPLPLPLPLvFPLPLPLPLPLPLPLPLPLPLPLPLgIPLPLPLPLPLPLPLPLPLPLPLPLPLPLPLPLPLPLPLPLPLPLPLPLPLPLPLPLPLPLPLPLPLPLdmdmdmdmdmdmdmaaaaaaaaaaaaaadmdmdmdmdmdmdmdmdmdmdmdmdmdmdmdmdmdmdmdmdmdm
dmdmdmdmdmdmdmdmdmdmdmdmdmdmdmdmaaaaaaaadmdmdmdmdmdmdmdmdmdmdmdmdmdmdmdmPLPLPLGgPLPLPLPLPLPLPLPLPLPLPLPLPLPLPLPLPLPLPLPLPLPLvFPLPLPLPLIAPLPLPLPLPLPLPLvFPLPLPLPLPLPLPLPLPLPLPLGgPLPLPLPLPLdmdmdmdmdmdmdmdmdmdmdmaaaaaaaaaaaadmdmdmdmdmdmdmdmdmdmdmdmdmdmdmdmdmdm
dmdmdmdmdmdmdmdmdmdmdmdmdmdmdmaaaaaadmdmdmdmdmdmdmdmdmdmdmdmdmdmdmdmdmPLPLPLPLPLGgPLPLPLPLPLPLPLPLPLPLPLPLPLPLPLPLPLPLPLPLPLPLPLPLPLPLPLPLPLGgPLPLPLPLPLPLPLPLPLPLPLPLPLPLPLPLPLPLPLPLPLPLPLdmdmdmdmdmdmdmdmdmdmdmdmdmdmaaaaaaaaaadmdmdmdmdmdmdmdmdmdmdmdmdmdmdm
dmdmdmdmdmdmdmdmdmdmdmdmdmaaaaaadmaadmdmdmdmdmdmdmdmdmdmdmdmdmdmdmdmdmPLPLPLPLPLPLPLPLPLPLGgPLPLPLPZPLPLPLPLPLPLPLPLPLPLPLPLPLPLPLPLPLPLPLPLPLPLPLPLPLPLPLPLPLPLPLIAPLPLPLPLPLPLPLPLPLPLPLPLdmdmdmdmdmdmdmdmdmdmdmdmdmdmdmdmdmaaaadmdmdmdmdmdmdmdmdmdmdmdmdmdmdm
dmdmdmdmdmdmdmdmdmdmdmdmaaaaaaaadmdmdmdmdmdmdmdmdmdmdmdmdmdmdmdmdmdmdmdmPLPLPLPLPLPLPLPLPLPLPLPLPLPLPLPLPLPLPLPLPLPLPLPLPLPLPLPLPLPLPLPLPLPLPLPLPLPLPLPLPLPLGgPLPLPLPLPLPLPLPLPLPLPLPLPLPLPLdmdmdmdmdmdmdmdmdmdmdmdmdmdmdmdmdmdmaaaaaadmdmdmdmdmdmdmdmdmdmdmdmdm
dmdmdmdmdmdmdmdmdmdmaaaaaaaadmdmdmdmdmdmdmdmdmdmdmdmdmdmdmdmdmdmdmdmdmPLPLPLGgPLPLPLPLPLGgPLPLPLPLPLPLPLPLPLPLPLPLPLIAPLPLPLGgPLPLPLPLPLIAPLPLPLPLPLPLPLPLPLPLPLPLPLPLPLPLPLPLPLPLPLPLPLPLPLdmdmdmdmdmdmdmdmdmdmdmdmdmdmdmdmdmdmdmaaaaaadmdmdmdmdmdmdmdmdmdmdmdm
dmdmdmdmdmdmdmdmdmdmaaaaaadmdmdmdmdmdmdmdmdmdmdmdmdmdmdmdmdmdmdmdmdmdmPLPLPLPLPLPLPLPLPLPLPLPLPLPLPLPLPLPLPLPLGgPLPLPLPLPLPLPLPLPLPLPLPLPLPLPLGgPLPLPLPLPLPLPLPLPLPLGgPLPLPLPLPLPLPLPLPLdmdmdmdmdmdmdmdmdmdmdmdmdmdmdmdmdmdmdmdmdmdmdmaaaadmdmdmdmdmdmdmdmdmdmdm
dmdmdmdmdmdmdmdmdmaaaaaadmdmdmdmdmdmdmdmdmdmdmdmdmdmdmdmdmdmdmdmdmdmdmPLPLvFvFPLPLPLPLPLPLPLPLPLPLPLPLPLPLPLPLPLPLPLPLPLPLPLPLGgPLPLPLPLPLPLPLPLIAPLPLPLPLPLPLPLPLPLPLPLPLPLPLPLPLPLPLPLdmdmdmdmdmdmdmdmdmdmdmdmdmdmdmdmdmdmdmdmdmdmdmdmaaaaaadmdmdmdmdmdmdmdmdm
dmdmdmdmdmdmdmdmdmaaaadmdmdmdmdmdmdmdmdmdmdmdmdmdmdmdmdmdmdmdmdmdmdmPLPLPLPLvFPLPLPLPLPLPLPLPLPLPLIAPLPLPLGgPLPLPLPLPLGgPLPLPLPLPLPLPLPLPLPLPLPLPLPLPLPLPLPLGgPLPLPLPLPLPLPLPLPLPLPLPLPLdmdmdmdmdmdmdmdmdmdmdmdmdmdmdmdmdmdmdmdmdmdmdmdmdmaaaaaadmdmdmdmdmdmdmdm
dmdmdmdmdmdmdmdmaaaadmdmdmdmdmdmdmdmdmdmdmdmdmdmdmdmdmdmdmdmdmdmdmdmPLPLGgPLPLvFvFPLPLPLPLPLPLPLPLPLPLPLPLPLPLPLPLPLPLPLPLPLPLPLPLPLPLPLPLPLPLPLPLPLPLPLPLPLPLPLPLPLPLIAPLPLPLPLPLPLPLPLPLPLPLdmdmdmdmdmdmdmdmdmdmdmdmdmdmdmdmdmdmdmdmdmdmdmdmaaaadmdmdmdmdmdmdm
dmdmdmdmdmdmdmdmaaaadmdmdmdmdmdmdmPLdmPLPLdmdmdmdmdmdmdmdmdmPLPLPLdmdmPLPLPLPLPLPLPLPLPLPLPLPLPLPLPLPLvFPLPLPLPLPLPLPLPLPLPLPLPLPLPLPLPLGgIAPLPLPLPLPLGgPLIAPLPLPLPLPLPLPLPLPLPLPLPLPLPLPLdmPLdmdmdmdmdmdmdmdmdmdmdmdmdmdmdmPLdmdmPLdmdmdmdmdmdmaaaaaadmdmdmdmdm
dmdmdmdmPLPLPLPLaaaadmdmdmdmdmdmdmPLPLGgPLdmdmdmdmdmdmdmdmPLPLdmPLPLPLPLPLPLPLPLPLPLPLPLPLPLPLGgPLPLPLPLPLPLPLPLUUPLmspkxPpkpkpkytaoaoaoAIPLPLPLPLPLPLPLPLPLPLPLPLPLPLPLPLPLPLPLPLPLPLPLPLdmPLPLPLdmdmdmdmdmdmdmdmdmdmdmPLPLPLPLdmPLPLdmdmdmdmaaaaaaaaaadmdmdmdm
dmdmPLPLPLPLPLPLdmdmdmdmdmdmdmdmPLPLPLPLPLPLPLPLdmdmPLdmPLPLdmdmPLPLPLPLPLPLPLPLGgPLPLPLPLPLPLPLPLPLPLPLPLGgPLPLPLPLejohPLWhYPHGqXHGHGHGmzPLPLPLPLIAPLPLPLPLPLPLGgPLPLPLGgPLPLPLPLPLPLPLPLdmdmPLdmdmdmdmdmdmdmdmdmdmPLPLPLPLdmPLPLPLdmdmdmdmdmdmdmdmaaaadmdmdmdm
dmPLPLPLPLPLPLPLPLPLPLPLPLPLPLPLPLPLPLGgPLPLPLDiPLSCPLPLPLPLPLPLPLPLPLPLPLPLPLPLPLPLPLPLPLPLPLPLPLPLPLPLPLPLPLWrXDXDWCwXXDQIohPLohPLPLPLPLGgPLPLPLPLPLPLPLPLPLPLPLPLPLPLPLPLPLPLPLPLPLPLGgPLPLPLDiPLSCPLPLPLPLPLPLPLPLPLPLPLPLPLPLPLPLPLPLPLPLPLPLPLPLPLPLPLPLdm
dmPLPLPLGgPLPLPLPLPLPLPLPLPLIAPLGgPLIAPLPLPLPLPLPLPLPLPLPLPLPLPLPLPLPLIAPLPLPLPLPLPLIAPLPLPLPLPLPLPLPLPLPLPLPLpXOvOvbPONvyVZziHGziHGgEPLPLPLPLPLPLPLPLPLPLPLPLPLPLPLPLPLPLPLPLPLPLGgPLPLPLPLPLPLPLPLGgPLPLPLPLPLPLPLPLPLPLPLPLPLPLPLPLPLPLGgPLPLIAPLPLPLPLPLPLdm
dmPLPLPLPLPLPLGgPLPLPLPLPLPLPLIAIAGgPLPLPLPLPLPLPLPLPLlVGgPLPLPLPLPLPLIAPLPLPLPLPLPLPLPLPLPLPLPLPLGgPLPLPLPLPLpXFwdnlAdntkWHPLPLPLPLohPLPLPLPLPLPLPLPLPLGgPLPLPLPLGgPLPLPLPLPLPLPLPLPLPLPLPLPLIAPLPLPLPLPLPLPLIAPLPLPLGgPLPLIAPLPLPLPLPLPLPLPLPLIAPLPLGgPLPLPLdm
mRPLPLIAPLPLPLPLGgPLPLPLPLPLPLGgPLPLPLPLPLPLGgPLPLPLPLlVPLPLPLPLGgPLPLPLPLPLPLPLPLPLPLPLPLPLPLPLPLPLPLPLPLPLPLpXbPOvbPOvkiWHPLGgPLNVlNHGpvyNPLCbhKPLPLPLPLPLPLPLPLPLPLPLgIPLPLPLPLPLPLPLPLPLPLPLPLPLPLPLPLPLPLPLPLPLPLPLPLPLPLPLPLIAPLGgPLPLPLPLPLPLPLPLPLPLPLdm
dmPLPLPLPLPLPLPLPLPLPLPLPLPLPLPLPLPLIAIAGgPLPLPLPLPLPLlVPLPLPLPLPLPLPLGgPLPLPLPLPLPLPLPLPLPLgIPLPLPLPLPLGgPLPLpXTVdnlAdnehWHPLPLPLPLPLPLPLEAPLEAPLPLPLPLPLPLPLPLPLPLPLPLPLPLPLPLPLvFPLPLPLPLPLPLEaPLPLPLPLGgPLPLPLPLPLPLPLPLPLPLPLPLPLPLPLIAPLPLPLPLPLPLPLPLPLdm
dmPLPLPLPLPLPLPLPLPLPLPLPLPLPLPLPLPLPLPLPLPLPLPLPLPLPLlVPLPLPLvFPLPLPLPLPLPLPLPLIAPLPLPLPLPLPLPLPLPLPLPLPLPLPLpXOvOvERdndneJuIuIjCXFPLPLPLEAPLEAPLPLPLPLPLPLIAPLPLPLPLPLPLPLPLPLPLPLPLPLPLPLPLPLEaPLPLGgPLPLPLPLPLGgPLPLIAPLPLPLPLPLPLPLPLGgPLPLGgPLPLPLIAPLPLdm
dmPLPLGgPLPLGgPLPLPLPLgIPLPLPLPLPLPLPLPLPLPLPLPLGgPLPLlVPLPLPLPLPLPLPLPLPLPLPLPLPLPLPLPLPLPLPLPLPLPLPLPLPLPLPLBgXWhNOKHOHOiLuIuINUuIuIbdvrmJcdmWPLGgPLPLPLPLPLPLPLPLPLPLPLGgPLPLPLPLPLPLPLPLPLPLEaPLPLPLPLPLgIPLPLPLPLPLPLPLPLPLIAPLPLPLPLPLPLPLPLPLPLPLPLPLPLdm
dmPLPLPLPLPLPLPLPLPLGgPLPLPLPLPLPLPLPLPLPLPLPLGgPLPLPLlVPLPLPLPLPLPLPLGgPLPLPLPLPLPLPLvFPLPLPLPLPLPLPLIAPLPLPLPLPLPLPLPLPLPLPLPLPLPLPLmMRePLPLPLPLPLPLPLPLPLPLPLIAPLPLPLPLPLPLPLPLPLPLPLPLIAPLPLEaPLPKPLPLPLPLPLPLPLPLPLPLGgPLPLPLPLPLPLIAPLPLPLPLPLPLPLPLPLPLdm
dmPLPLPLPLPLPLPLPLPLPLPLPLPLPLPLPLGgPLPLPLPLPLPLPLPLPLlVPLPLGgPLPLPLPLPLPLPLPLPLPLPLPLPLPLPLPLPLPLPLPLPLPLPLPLPLPLPLPLPLPLPLPLPLPLPLPLPLPLPLPLPLPLPLPLPLPLPLPLPLPLPLPLPLPLPLGgPLPLPLPLGgPLPLPLPLPLPLPLPLPLPLPLPLGgPLPLPLPLPLPLPLPLPLPLPLPLPLPLPLPLIAPLPLPLPLPLdm
dmGgPLIAPLPLPLPLGgPLPLPLPLPLPLPLPLPLPLPLPLPLPLPLPLPLPLPLPLPLPLPLPLGgPLPLPLPLPLPLPLPLPLPLPLPLPLPLPLPLPLPLPLPLGgPLPLPLPLPLPLGgPLGgPLPLPLPLGgPLPLPLPLPLPLPLPLPLPLPLPLPLPLPLPLPLPLPLPLPLPLPLPLPLPLPLPLPLPLPLPLPLPLPLPLIAPLPLGgPLPLPLGgPLPLPLPLPLPLPLPLPLPLPLPLPLPLdm
dmPLPLPLPLPLPLPLPLPLPLPLPLPLPLPLPLPLPLPLPLPLPLGgPLPLPLPLPLPLPLPLPLPLPLPLPLPLPLPLPLPLPLPLPLPLPLgIPLPLPLPLPLPLPLPLPLPLPLPLPLPLPLPLPLPLPLPLPLPLPLPLPLPLGgPLPLPLPLvFPLPLPLPLPLPLPLPLPLPLPLPLPLPLPLPLPLPLPLPLGgPLPLPLPLPLPLPLPLPLPLPLPLPLIAPLPLPLPLPLPLPLPLPLPLPLPLdm
dmPLPLPLPLPLdmdmdmdmdmdmPLPLPLdmdmdmdmdmdmPLPLPLPLdmdmdmPLPLPLPLPLPLPLPLPLgIPLPLPLPLPLPLPLPLPLPLPLPLPLPLPLPLPLPLPLPLPLPLPLPLPLPLPLPLPLPLPLPLPLPLPLPLPLPLPLPLPLvFvFPLPLPLPLPLPLPLPLPLPLPLPLPLPLdmdmdmdmPLPLPLdmdmdmdmdmdmdmdmdmdmdmdmdmdmdmdmdmdmdmdmdmdmaaaaaadm
dmPLPLPLPLPLdmdmdmdmPLPLPLPLdmdmdmdmdmdmdmdmPLPLPLdmdmdmdmdmPLPLPLPLPLPLPLPLPLGgPLPLPLGgPLPLGgPLPLPLPLPLPLPLPLPLPLPLPLPLIAPLPLPLPLPLIAPLPLPLPLPLPLgIPLPLPLPLPLPLvFPLPLPLPLPLIAPLPLPLPLPLPLPLdmdmdmPLPLPLPLPLdmdmdmdmdmdmdmdmdmdmdmdmdmdmdmdmdmaaaaaaaaaaaaaadmdm
dmdmdmdmdmaaaadmdmdmdmPLPLPLdmdmdmdmdmdmdmdmdmdmdmdmdmdmdmdmdmdmPLdmdmPLPLPLPLPLPLPLPLPLPLPLPLPLPLPLPLPLPLkHPLPLPLPLPLPLPLPLPLGgPLPLPLPLPLPLPLPLPLPLPLPLPLPLPLPLPLPLPLPLPLPLPLPLPLPLPLPLPLdmdmPLPLPLPLdmdmdmdmdmdmdmdmdmdmdmdmdmdmdmdmdmdmdmaaaadmdmdmdmdmdmdmdm
dmdmdmdmdmdmaadmdmdmdmdmdmdmdmdmdmdmdmdmdmdmdmdmdmdmdmdmdmdmdmdmPLPLdmPLPLPLPLPLPLPLPLPLPLPLPLPLGgPLPLPLPLPLPLPLPLPLPLPLPLPLPLPLIAPLPLPLPLPLPLPLPLPLPLPLPLPLPLPLPLPLPLPLPLPLPLPLPLPLPLPLdmdmPLPLdmdmdmdmdmdmdmdmdmdmdmdmdmdmdmdmdmdmdmdmdmdmaaaadmdmdmdmdmdmdmdm
dmdmdmdmdmaaaaaadmdmdmdmdmdmdmdmdmdmdmdmdmdmdmdmdmdmdmdmdmdmdmdmdmPLPLPLPLPLIAPLPLPLPLPLPLPLPLPLPLPLPLPLPLPLPLPLPLPLPLPLPLPLPLPLPLPLPLPLPLPLPLPLPLPLPLPLPLPLPLPLPLPLPLPLPLPLgIPLPLPLPLPLPLPLPLdmdmdmdmdmdmdmdmdmdmdmdmdmdmdmdmdmdmdmdmdmdmaaaadmdmdmdmdmdmdmdmdm
dmdmdmdmdmdmdmaaaaaadmdmdmdmdmdmdmdmdmdmdmdmdmdmdmdmdmdmdmdmdmdmdmdmdmPLPLPLPLPLPLPLGgPLPLPLPLPLPLPLPLPLPLPLPLPLPLPLPLPLGgPLPLPLPLPLPLPLPLPLPLGgPLPLPLPLPLPLPLPLPLPLPLPLPLPLPLPLPLPLPLGgdmdmdmdmdmdmdmdmdmdmdmdmdmdmdmdmdmdmdmdmdmdmdmdmaaaadmdmdmdmdmdmdmdmdmdm
dmdmdmdmdmdmdmdmaaaaaaaaaaaaaaaaaadmdmdmdmdmdmdmdmdmdmdmdmdmdmdmdmdmdmdmPLPLPLPLPLPLPLPLPLPLPLPLgIPLPLPLPLPLvFPLPLPLPLPLPLPLPLPLPLPLPLPLPLPLPLPLPLPLPLvFPLPLPLPLPLPLPLPLPLPLPLPLPLPLPLPLdmdmdmdmdmdmdmdmdmdmdmdmdmdmdmdmdmdmdmdmdmdmdmaaaadmdmdmdmdmdmdmdmdmdmdm
dmdmdmdmdmdmdmdmdmdmdmabababaaaaaaaaaaaadmdmdmdmdmdmdmdmdmdmdmdmdmdmdmPLPLGgPLPLPLIAPLPLPLPLPLPLPLPLPLPLPLPLPLPLPLPLPLPLPLPLPLPLPLPLPLPLPLPLPLPLPLPLPLvFPLPLPLPLPLPLPLPLPLPLPLPLPLPLPLPLdmdmdmdmdmdmdmdmdmdmdmdmdmdmdmdmdmdmdmdmdmdmdmaaaadmdmdmdmdmdmdmdmdmdmdm
dmdmdmdmdmdmdmdmdmdmdmdmdmdmaadmdmdmaaaaaaaadmdmdmdmdmdmdmdmdmdmdmdmPLPLPLPLPLPLPLPLPLPLPLPLPLPLPLPLPLPLPLPLPLPLPLPLPLIAPLPLPLPLvFPLPLPLPLPLPLPLPLPLvFPLPLPLPLPLPLPLPLPLPLPLPLPLPLPLvFPLPLdmdmdmdmdmdmdmdmdmdmdmdmdmdmdmdmdmdmdmdmdmaaaadmdmdmdmdmdmdmdmdmdmdmdm
dmdmdmdmdmdmdmdmdmdmdmdmdmdmdmdmdmdmdmaaaaaaaadmaadmdmdmdmdmdmdmdmPLPLPLIAPLPLPLPLPLPLvFPLPLPLPLPLIAPLPLPLPLPLPLPLPLPLPLPLPLPLPLPLPLPLPLPLPLPLPLPLPLPLPLPLPLPLPLPLPLPLPLPLPLPLPLPLPLPLPLPLdmdmdmdmdmdmdmdmdmdmdmdmdmdmdmdmdmdmaaaaaaaadmdmdmdmdmdmdmdmdmdmdmdmdm
dmdmdmdmdmdmdmdmdmdmdmdmdmdmdmdmdmdmdmdmdmaaaaaaaaaaaadmdmdmdmaaaaPLPLPLPLPLPLPLPLPLPLvFPLIAPLPLPLPLPLPLPLPLIAPLPLPLPLPLPLPLPLPLPLPLPLPLPLPLPLPLPLPLPLPLPLPLPLPLPLSvXDXDXDXDXDXDXDsvPLPLPLPLPLdmdmdmdmdmdmdmdmdmdmdmdmdmdmdmaaaaaaaadmdmdmdmdmdmdmdmdmdmdmdmdmdm
dmdmdmdmdmdmdmdmdmdmdmdmdmdmdmdmdmdmdmdmdmdmdmdmaaaaaaaaaaaaaaaadmdmdmPLPLPLIAPLPLPLPLPLPLPLPLPLPLPLPLPLPLPLPLPLPLIAPLPLPLPLPLPLPLPLPLPLPLPLPLPLPLPLPLPLPLPLPLPLPLpXRpyzOvOvOvRpyzWHaLPLPLPLPLdmdmdmdmdmdmdmdmdmaaaaaaaaaaaaaadmdmdmdmdmdmdmdmdmdmdmdmdmdmdmdmdm
dmdmdmdmdmdmdmdmdmdmdmdmdmdmdmdmdmdmdmdmdmdmdmdmdmdmaadmdmdmaaaadmdmPLPLPLPLPLPLPLPLPLPLPLPLPLPLPLPLPLPLPLPLPLPLPLPLPLGgPLPLPLPLPLPLPLGgPLPLPLPLPLPLPLPLPLPLPLPLPLpXOvOvOvOvOvOvOvWHEAPLPLPLPLdmdmdmdmdmdmdmaaaaaadmaaaadmdmdmdmdmdmdmdmdmdmdmdmdmdmdmdmdmdmdmdm
dmdmdmdmdmdmdmdmdmdmdmdmdmdmdmdmdmdmdmdmdmdmdmdmdmdmdmdmdmdmdmdmdmdmdmPLPLPLPLPLPLPLPLPLPLPLPLPLPLPLPLPLIAPLPLPLPLPLPLPLPLgIPLPLPLPLPLPLPLPLIAPLPLPLPLPLPLPLPLPLPLpXOvOvOvOvOvOvOvWHaLPLPLPLPLaaaaaadmdmdmdmaaaaaadmdmdmdmdmdmdmdmdmdmdmdmdmdmdmdmdmdmdmdmdmdmdm
dmdmdmdmdmdmdmdmdmdmdmdmdmdmdmdmdmdmdmdmdmdmdmdmdmdmdmdmdmdmdmdmdmdmdmPLPLPLPLPLPLPLPLPLPLPLPLIAPLPLPLPLPLPLPLPLPLPLPLPLPLPLPLPLPLPLPLPLPLPLPLPLPLPLPLPLPLPLPLPLPLpXRpyzOvUjOvRpyzWHEAPLPLPLdmdmdmaaaaaaaaaaaaaadmdmdmdmdmdmdmdmdmdmdmdmdmdmdmdmdmdmdmdmdmdmdmdm
dmdmdmdmdmdmdmdmdmdmdmdmdmdmdmdmdmdmdmdmdmdmdmdmdmdmdmdmdmdmdmdmdmdmPLPLPZPLPLPLPLPLPLIAPLPLPLPLPLPLPLPLPLPLPLPLPLPLPLPLPLPLPLPLPLPLPLPLPLPLPLPLPLPLPLPLPLPLPLPLPLpXOvOvOvOvOvOvOvWHaLPLPLPLdmdmdmdmdmdmdmdmdmdmdmdmdmdmdmdmdmdmdmdmdmdmdmdmdmdmdmdmdmdmdmdmdmdm
dmdmdmdmdmdmdmdmdmdmdmdmdmdmdmdmdmdmdmdmdmdmdmdmdmdmdmdmdmdmdmdmdmdmPLPLPLPLPLPLPLPLPLPLPLPLPLPLPLPLPLPLPLPLPLPLPLPLPLPLPLPLPLPLPLIAPLPLPLPLPLPLPLPLPLPLPLPLPZPLPLpXOvOvOvOvOvOvOvWHEAPLPLPLPLdmdmdmdmdmdmdmdmdmdmdmdmdmdmdmdmdmdmdmdmdmdmdmdmdmdmdmdmdmdmdmdmdm
dmdmdmdmdmdmdmdmdmdmdmdmdmdmdmdmdmdmdmdmdmdmdmdmdmdmdmdmdmdmdmdmdmdmdmPLPLPLPLPLPLPLPLPLPLPLPLPLPLPLPLPLPLPLPLPLIAPLPLPLPLPLPLPLPLPLPLPLPLPLPLPLPLPLPLPLPLPLPLPLPLpXRpyzOvOvOvRpyzWHaLPLPLPLdmdmdmdmdmdmdmdmdmdmdmdmdmdmdmdmdmdmdmdmdmdmdmdmdmdmdmdmdmdmdmdmdmdm
dmdmdmdmdmdmdmdmdmdmdmdmdmdmdmdmdmdmdmdmdmdmdmdmdmdmdmdmdmdmdmdmdmdmdmdmPLPLPLPLPLPLPLPLvFvFvFPLPLPLIAPLPLPLPLPLPLPLPLPLPLPLPLPLPLPLPLPLPLPLPLPLPLPLPLPLPLPLPLPLPLPdXWXWXWXWXWXWXWTmPLPLdmdmdmdmdmdmdmdmdmdmdmdmdmdmdmdmdmdmdmdmdmdmdmdmdmdmdmdmdmdmdmdmdmdmdmdm
dmdmdmdmdmdmdmdmdmdmdmdmdmdmdmdmdmdmdmdmdmdmdmdmdmdmdmdmdmdmdmdmdmdmdmdmdmdmPLPLPLPLPLPLPLPLvFvFPLPLPLPLPLPLPLPLPLPLPLPLPLvFPLPLPLPLPLPLPLPLPLPLPLPLPLPLPLPLPLPLPLPLPLPLPLPLPLPLPLPLPLdmdmdmdmdmdmdmdmdmdmdmdmdmdmdmdmdmdmdmdmdmdmdmdmdmdmdmdmdmdmdmdmdmdmdmdmdm
dmdmdmdmdmdmdmdmdmdmdmdmdmdmdmdmdmdmdmdmdmdmdmdmdmdmdmdmdmdmdmdmdmdmdmdmdmdmdmdmPLPLPLPLPLPLPLvFPLPLPLPLPLPLPLPLPLPLPLPLPLPLPLPLPLPLPLPLPLPLPLPLPLPLPLPLPLPLPLPLPLPLPLPLPLPLPLPLdmdmdmdmdmdmdmdmdmdmdmdmdmdmdmdmdmdmdmdmdmdmdmdmdmdmdmdmdmdmdmdmdmdmdmdmdmdmdmdm
dmdmdmdmdmdmdmdmdmdmdmdmdmdmdmdmdmdmdmdmdmdmdmdmdmdmdmdmdmdmdmdmdmdmdmdmdmdmdmdmdmdmPLPLPLPLPLPLPLPLPLPLPLPLPLPLPLPLPLPLPLPLPLPLPLPLPLPLPLPLIAPLPLPLPLPLPLPLPLPLPLPLPLPLPLdmdmPLPLdmdmdmdmdmdmdmdmdmdmdmdmdmdmdmdmdmdmdmdmdmdmdmdmdmdmdmdmdmdmdmdmdmdmdmdmdmdmdm
dmdmdmdmdmdmdmdmdmdmdmdmdmdmdmdmdmdmdmdmdmdmdmdmdmdmdmdmdmdmdmdmdmdmdmdmdmdmdmdmdmdmdmdmdmPLdmPLPLPLPLPLPLPLPLPLIAPLPLPLPLPLPLPLPLPLPLPLPLPLPLPLPLPLPLPLPLPLPLPLPLPLPLPLdmdmdmdmdmdmdmdmdmdmdmdmdmdmdmdmdmdmdmdmdmdmdmdmdmdmdmdmdmdmdmdmdmdmdmdmdmdmdmdmdmdmdmdm
dmdmdmdmdmdmdmdmdmdmdmdmdmdmdmdmdmdmdmdmdmdmdmdmdmdmdmdmdmdmdmdmdmdmdmdmdmdmdmdmdmdmdmdmdmdmdmdmdmPLPLPLPLPLPLPLPLPLPLPLPLPLPLPLPLPLPLPLPLPLPLPLPLPLvFPLPLPLPLPLPLdmPLdmdmdmdmdmdmdmdmdmdmdmdmdmdmdmdmdmdmdmdmdmdmdmdmdmdmdmdmdmdmdmdmdmdmdmdmdmdmdmdmdmdmdmdmdm
acdmdmdmdmdmdmdmdmdmdmdmdmdmdmdmdmdmdmdmdmdmdmdmdmdmdmdmdmdmdmdmdmdmdmdmdmdmdmdmdmdmdmdmdmdmdmdmdmdmdmdmdmdmdmdmdmdmdmdmdmdmdmdmdmdmdmdmdmdmdmdmdmdmdmdmdmdmdmdmdmdmdmdmdmdmdmdmdmdmdmdmdmdmdmdmdmdmdmdmdmdmdmdmdmdmdmdmdmdmdmdmdmdmdmdmdmdmdmdmdmdmdmdmdmdmdmdm
"}
